WWWWWWWWWWWWWWWW
W..............W
W*WW.WWWW.WWWW.W
W.WW.WWWW.WWWW.W
W..............W
WWWWWWWWWWWWWW.W
W..............W
W.WWWWW.WWWWWW.W
W..............W
W.WW-WW.WWWWWW.W
W.W-G-W.W..*...W
W.WWWWW.W.WWWW.W
W...F..........W
W...WWWW.W.W.W.W
WWW......W.W.W.W
W...WWWW.W.W.W*W
W*W.W....W.W.W.W
W...W.WW.W.W.W.W
WWW.W.WW.W.W.W.W
W........W.W.W.W
W*W......W.W.W.W
W.W.WWWWWW.W.W.W
W......P.......W
WWWWWWWWWWWWWWWW