WWWWWWWWWWWWWWWWWWW
W.................W
W*WW.WWWW.WWWW....W
W.WW.WWWW.WWWW....W
W......F..........W
WWWWWWWWWWWWWW....W
W.................W
W.WWWWW.WWWWWW....W
W........F........W
W.WWWWWWWW.WWWW...W
W.W-GGGG-W.W..*...W
W.WW----WW.WWWW...W
W...F.............W
W...WWWW.W.W.W....W
WWW......W.W.W....W
W...WWWW.W.W.W*...W
W*W.W....W.W.W....W
W...W.WW.W.W.W....W
WWW.W.WW.W.W.W....W
W........W.W.W....W
W*W......W.W.W....W
W.W.WWWWWW.W.W....W
W......P..........W
WWWWWWWWWWWWWWWWWWW